MWMMMMMMMMMMMMMMWWMMMMWWWWWWWWWWWWWWMMMMMMMMLLM$$F?MMMMSMSSSSSSMMSSSSSSMSMMMM?F$$MLLMMMMMMMMWWWWWWWWWWWWWWMMMMWWMMMMMMMMMMMMMMWM
WWMWWMMMWMWWMWWWWWMWWMWWWWWWWWWWWMMMMMSSMMMMMLLMFFMMLMMSSSMSSMMMMMMSSMSSSMMLMMFFMLLMMMMMSSMMMMMWWWWWWWWWWWMWWMWWWWWMWWMWMMMWWMWW
MWWWWWWWMWWMWWMWWWWWWWWWWWWMMWWWWMMMMMMSSSMMMMLMFMLLLMMMSSMMMMMMMMMMMMSSMMMLLLMFMLMMMMSSSMMMMMMWWWWMMWWWWWWWWWWWWMWWMWWMWWWWWWWM
MWWWWWMWWWWWWWWWWWMWWWWWWMWWWWWWWWMMMMMMMSSSSMMLL!MMMLLMMSMLLLLLLLLLLMSMMLLMMM!LLMMSSSSMMMMMMMWWWWWWWWMWWWWWWMWWWWWWWWWWWMWWWWWM
MWMWMMMMMWWWMWWWWWWWWWWWWWWMMWMMMMMMMMMMMMSSSMMMMLMMMMMLMSM!!MM!!MM!!MSMLMMMMMLMMMMSSSMMMMMMMMMMMMWMMWWWWWWWWWWWWWWMWWWMMMMMWMWM
MWWWMMMMMMMWWMWMWWWWWWWWMWWMMMMMMMMMMMFMMMMMMMMMMMLLMMMMMSMLMLL!!LLMLMSMMMMMLLMMMMMMMMMMMFMMMMMMMMMMMWWMWWWWWWWWMWMWWMMMMMMMWWWM
WWWMMMMMMMWWWWWMWLWWWM$MWWMMMMSSSSMMMMMMMMMMMMMMMMMMLLTMMSMLMLMMMMLMLMSMMTLLMMMMMMMMMMMMMMMMMMSSSSMMMMWWM$MWWWLWMWWWWWMMMMMMMWWW
WWWSSMSMMMMWWWWWWWWWWWMWWWMMMMSSSSSSSMMMMMMMMWWMMMMMMMLMMSSLMLMDDMLMLSSMMLMMMMMMMWWMMMMMMMMSSSSSSSMMMMWWWMWWWWWWWWWWWMMMMSMSSWWW
WMMMSSSMMLMWWWWWWWWWWWWWMWMMMMMMMSSSSSSMMMWWWWWW?MMMMMLMMSSLMLMMMMLMLSSMMLMMMMM?WWWWWWMMMSSSSSSMMMMMMMWMWWWWWWWWWWWWWMLMMSSSMMMW
WWMMMMSSMMWWWWWWWWMWWWWWWWWMMMMMSSSMMMMMMMMWWWWWMMMMMMMMMSMLMLLLLLLMLMSMMMMMMMMMWWWWWMMMMMMMMSSSMMMMMWWWWWWWWMWWWWWWWWMMSSMMMMWW
MWWSS?MSSSWWWWWWWWWWWWWWWWWMFMMSSMMLLLLLMMMMWWWWWWSSSSMMSMMLM@M!!MMMLMMSMMSSSSWWWWWWMMMMLLLLLMMSSMMFMWWWWWWWWWWWWWWWWWSSSM?SSWWM
MWWWSWSSWWWWLLWWWWWWWWMWMWWMMMMSMMML$M$LMMMMWWWWMMSMMSSSSMMLLLL!!LLLLMMSSSSMMSMMWWWWMMMML$M$LMMMSMMMMWWMWMWWWWWWWWLLWWWWSSWSWWWM
MWWWSSSSWWWWLLWWWWWWWWWWMMMMMMMMMMMLM?M!!MMMWWWMMMMMMSMMSSSMMMMMMMMMMSSSMMSMMMMMMWWWMMM!!M?MLMMMMMMMMMMMWWWWWWWWWWLLWWWWSSSSWWWM
MWWWWWSSWWWWWWWWWWWMWWWMMMMMMMMMMMML$M$LMMMMWWMMMMWMMSMMMMSSMMMMMMMMSSMMMMSMMWMMMMWWMMMML$M$LMMMMMMMMMMMMWWWMWWWWWWWWWWWSSWWWWWM
MWWMWWWWWWWWWWWWWWWWWWFMMMMMMMMMMMFLLLLLSSSMMWMMMMWWMSMMFMMSSSMMMMSSSMMFMMSMWWMMMMWMMSSSLLLLLFMMMMMMMMMMMFWWWWWWWWWWWWWWWWWWMWWM
MWWMWWWWWWWWWWWWWWMWWWFFMMMMMMMMMMMMMMMMSMMMMWMMMMMWMSSMMMMSSSMMMMSSSMMMMSSMWMMMMMWMMMMSMMMMMMMMMMMMMMMMFFWWWMWWWWWWWWWWWWWWMWWM
MWWWWWMWWWWWWWWWLWWWWWMMMMMMMMMMMMMMMMMMMMMMMWMMMMMWWWSSMMSSMMMMMMMMSSMMSSWWWMMMMMWMMMMMMMMMMMMMMMMMMMMMMMWWWWWLWWWWWWWWWMWWWWWM
MMWWMWWWWWWWWWWWWWWWWWWFMMMFMMMMWWWMMMMMMMMMMMMMMMMMMMMMMSSSMMMMMMMMSSSMMMMMMMMMMMMMMMMMMMMMMWWWMMMMFMMMFWWWWWWWWWWWWWWWWWWMWWMM
WWWWWSSSWWWWWWWWWWWWFFWFMMMMMWMMWWWMMMMMMM!MMMMMMMWMMMMSSSSSMMMMMMMMSSSSSMMMMWMMMMMMM!MMMMMMMWWWMMWMMMMMFWFFWWWWWWWWWWWWSSSWWWWW
WMWWWSMSSWWWWWWWWWWWMFFMMMMMMWMWMWWMMMMMMMMMMMMMMMWMMMMSMSSSMMFMMFMMSSSMSMMMMWMMMMMMMMMMMMMMMWWMWMWMMMMMMFFMWWWWWWWWWWWSSMSWWWMW
WWWWWSSMSWWWWWWWWWWWWMWMMMMMMMMMMMMMMMMMFMMM!MMMMMMMMMMSSSSSSSMMMMSSSSSSSMMMMMMMMMM!MMMFMMMMMMMMMMMMMMMMMWMWWWWWWWWWWWWSMSSWWWWW
WWMWWWWMSWWWWWWWWWMWWWWMMMMMMMWMMMMMWMMMMMMMMMMMMMMMMMMMMMMSSSSSSSSSSMMMMMMMMMMMMMMMMMMMMMMWMMMMMWMMMMMMMWWWWMWWWWWWWWWSMWWWWMWW
WWWWWWWWWWWWWWWWWWWWWWWMMMMMMMMMMMMMMMMMMMMMMMMM!MMMMMWWMMMMMMMMMMMMMMMMWWMMMMM!MMMMMMMMMMMMMMMMMMMMMMMMMWWWWWWWWWWWWWWWWWWWWWWW
MWWWMWWMMWWWWWLLLLLLLWWWMMMMMMMMMMMMMMMMMMMMMMMM!MMMMMMMMMMMMMMMMMMMMMMMMMMMMMM!MMMMMMMMMMMMMMMMMMMMMMMMWWWLLLLLLLWWWWWMMWWMWWWM
MWWWMWWWWWWWWHMMMMMMMLWWWWWLWWMMMMMMMMMMFMMMMMMMMMMMMMMMMMMMMMMMMMMMMMMMMMMMMMMMMMMMMMMFMMMMMMMMMMWWLWWWWWLMMMMMMMHWWWWWWWWMWWWM
WWWWWWWWWWWWWWLLLLLMMMLWWWMWWWMMWWWMMMMMMMMMMMMMMMMMMMMMWMWMMMMMMMMMMWMWMMMMMMMMMMMMMMMMMMMMMWWWMMWWWMWWWLMMMLLLLLWWWWWWWWWWWWWW
MWWWWWWWWWWWWWWWWMM$M!MMWLWWWWWWMWWWWWWMMMMMMMMMMMFMMWWWWWWWWWWWWWWWWWWWWWWMMFMMMMMMMMMMMWWWWWWMWWWWWWLWMM!M$MMWWWWWWWWWWWWWWWWM
MMWWWWWWWWWWWWWWW!!!!MMMMMWWWWWWWWWWWWWMMMMMMMMMMMMWWWWWWWWWWWWWWWWWWWWWWWWWWMMMMMMMMMMMMWWWWWWWWWWWWWMMMMM!!!!WWWWWWWWWWWWWWWMM
MWWWWWWWWWWWWWWMWM!MMMMMMMWWMMMMMMMMWWWWWMMMMMMMMWWWWWWWWMMMMWWWWWWMMMMWWWWWWWWMMMMMMMMWWWWWMMMMMMMMWWMMMMMMM!MWMWWWWWWWWWWWWWWM
MWMMWWWMWWMMWWWMWMMMMMMMMMWWMFMSMMSMMWWWWWWMMMMMWWWWMMMMMMMMFMMWWMMFMMMMMMMMWWWWMMMMMWWWWWWMMSMMSMFMWWMMMMMMMMMWMWWWMMWWMWWWMMWM
MWDMWWWWWWWWWWMWMMMMSSMMMMMWWMMMMMSMMWWWWWW!MMMWWWMMMMMMMMMMMMMMMMMMMMMMMMMMMMWWWMMM!WWWWWWMMSMMMMMWWMMMMMSSMMMMWMWWWWWWWWWWMDWM
MWDDMWWWWWWMWMWWMMMMMSMMMMMWWFMMMSSMMMWMWW!WWMWWWWMMFMMMMMMMMMMMMMMMMMMMMMMFMMWWWWMWW!WWMWMMMSSMMMFWWMMMMMSMMMMMWWMWMWWWWWWMDDWM
MWLL!WMWWWWWWWMMMMMMSSMMWMMWWMMMMSMSMMMMM!WWWWWWWWMMMMMMMMMMMMMMMMMMMMMMMMMMMMWWWWWWWW!MMMMMSMSMMMMWWMMWMMSSMMMMMMWWWWWWWMW!LLWM
MMMMMWWWWMWWWMMMMFMMMSMWWMMWWFMMMMMMMMSMMMMWWWWWMMMMMMMMMMMMMMMMMMMMMMMMMMMMMMMMWWWWWMMMMSMMMMMMMMFWWMMWWMSMMMFMMMMWWWMWWWWMMMMM
MMWMWWWWWWMWMMMMMMMMMMMMWMMWWMMMMMMMMMMSMMMMMWMMMMMMM!MMMMMFMMMMMMMMFMMMMM!MMMMMMMWMMMMMSMMMMMMMMMMWWMMWMMMMMMMMMMMMWMWWWWWWMWMM
MMWWWWWWWWWWMMMMMMMMMMMMWMMMWWFMMMMMMMMMSMMMMMMMMWWMMMMM!!MMMMMMMMMMMM!!MMMMMWWMMMMMMMMSMMMMMMMMMFWWMMMWMMMMMMMMMMMMWWWWWWWWWWMM
MMWWWWMWWWWWMMMMMMMMMMMMMMMMWWMMMMMMMMMMSMMMMMMMMWWMM!MM!D!MMMMMMMMMM!D!MM!MMWWMMMMMMMMSMMMMMMMMMMWWMMMMMMMMMMMMMMMMWWWWWMWWWWMM
MMWWWWWWWWWWMMMMMMMF!MMMMMMMWMFMMMMM$MMMSSMMMMMMMMMM!MMMM!MMMM!MM!MMMM!MMMM!MMMMMMMMMMSSMMM$MMMMMFMWMMMMMMM!FMMMMMMMWWWWWWWWWWMM
WWWWWWWWWWWMWMMMMMM!MMMMMMMMWWMMMMMMMMMS$SMMMFMMMMMMMMMMMMMMMM!!!!MMMMMMMMMMMMMMMMFMMMS$SMMMMMMMMMWWMMMMMMMM!MMMMMMWMWWWWWWWWWWW
WWWWWWWWWMWWWMMMMMMMMM!$!!MMWWMMMMMMMMMSSSSMMMMMMMMMM!!!MMMMMMMMMMMMMMMM!!!MMMMMMMMMMSSSSMMMMMMMMMWWMM!!$!MMMMMMMMMWWWMWWWWWWWWW
MWWWWWWWWMWWWMMMMMMMMMM!$MMMMWWMMMMMMMMSSMSMMM!!MMMMMM!MMMMFMMMMMMMMFMMMM!MMMMMM!!MMMSMSSMMMMMMMMWWMMMM$!MMMMMMMMMMWWWMWWWWWWWWM
WWWWWWWWWWWWWWWMMMMMMMMM!MMMMWWWMMMMMMMMMMMMMMM!MMMMMMMMMM!MMMMMMMMMM!MMMMMMMMMM!MMMMMMMMMMMMMMMWWWMMMM!MMMMMMMMMWWWWWWWWWWWWWWW
WWWWWWWMWWMWMMWWMWWMMMMMMMMMM!!WWWWM$MMMMMMMMMMMMMMMMMMMMMM!MMMMMMMM!MMMMMMMMMMMMMMMMMMMMMM$MWWWW!!MMMMMMMMMMWWMWWMMWMWWMWWWWWWW
MWWMWWWWWWWMMMMWWWWMMMMMMMMMMM!!WWHMMMMMM!!MMMMMMMMMMMSMMMMLMLMLLMLMLMMMMSMMMMMMMMMMM!!MMMMMMHWW!!MMMMMMMMMMMWWWWMMMMWWWWWWWMWWM
MWWWWWWWWMMMMMMMWMWWMMM$MMMMMMM!MWMMMMMMM!!!MMMMMSSMMMMMMMMLMLMLLMLMLMMMMMMMMSSMMMMM!!!MMMMMMMWM!MMMMMMM$MMMWWMWMMMMMMMWWWWWWWWM
SWWWWWWMMMMMMMMMMMWWMMMMMMMMMMMMMMMMMMMM!B!MMMMMMMSSMMMMMMML$MMMMMM$LMMMMMMMSSMMMMMMM!B!MMMMMMMMMMMMMMMMMMMMWWMMMMMMMMMMMWWWWWWS
SWWMMMMMMMMM!MMMMMMMMMMMMMMMMMMMMMMMMMM!!!!MMMLLLMSMMMMMMMMLMMMMMMMMLMMMMMMMMSMLLLMMM!!!!MMMMMMMMMMMMMMMMMMMMMMMMMM!MMMMMMMMMWWS
MWWMMM!M!!MMMMSMMMMMMMMMMMMMFMMMMMMMMMMMMFMMMLLMLLSSMMMMMLLLLMMMMMMLLLLMMMMMSSLLMLLMMMFMMMMMMMMMMMMFMMMMMMMMMMMMMSMMMM!!M!MMMWWM
MWWMMMMMMMMMMMSSSSMMMMMMMMMFMFMMMMMMMMWMMMMMLLMFMLLSSMLLLLMMMMMMMMMMMMLLLLMSSLLMFMLLMMMMMWMMMMMMMMFMFMMMMMMMMMSSSSMMMMMMMMMMMWWM
MWMMMMMMMMMMSSSSSMSMMMMMMMMMFMMMMSSMMWWWMMMMLMMMMMMMMMMMMMMMMMMMMMMMMMMMMMMMMMMMMMMLMMMMWWWMMSSMMMMFMMMMMMMMMSMSSSSSMMMMMMMMMMWM
MWMMMMMMMMMMSSSSSSMSMM!MMMMMMMMMMSSSMMMWMMMMLMMFMMMLLLMLLLMLLLMMMMLLLMLLLMLLLMMMFMMLMMMMWMMMSSSMMMMMMMMMM!MMSMSSSSSSMMMMMMMMMMWM
MWMMMMM$MMMMMSSSMSSSMMMMMMMMMMMMMMS!MMMWMFMMLLMMMMMLLLLLLLLLLL$MM$LLLLLLLLLLLMMMMMLLMMFMWMMM!SMMMMMMMMMMMMMMSSSMSSSMMMMM$MMMMMWM
WWMMMMMMM$MMMMSSSSSSMMMMMMMMMMMMMMMSSMMMMMMMMLLMMMMLLL?LLL$LLLMMMMLLL$LLL?LLLMMMMLLMMMMMMMMSSMMMMMMMMMMMMMMMSSSSSSMMMM$MMMMMMMWW
WWWMMMML?LMMMMSSSSSSSMM!MMMMFMMMSMMMSSMMMMMMMMLLMMMMLMMMMMMMMSSMMSSMMMMMMMMLMMMMLLMMMMMMMMSSMMMSMMMFMMMM!MMSSSSSSSMMMML?LMMMMWWW
WWWMMM!LLLMMMMSSSSSSSMMMMMMM!MMMMMMMMSMMMMMMMMMLLMMLLLMTMMMFMMSSSSMMFMMMTMLLLMMLLMMMMMMMMMSMMMMMMMM!MMMMMMMSSSSSSSMMMMLLL!MMMWWW
WWWMMLTLMMMMMSSSS$SSSSMMMMMMMMMMMMMMMMMMMMMMMMMMMMMLLLTMMMMMMMMSSMMMMMMMMTLLLMMMMMMMMMMMMMMMMMMMMMMMMMMMMMSSSS$SSSSMMMMMLTLMMWWW
WWWMMLLMMMMMMSMSMMSSSSMWWMMMMMMMMMMMMMMMMMMMMMMMMMMLLLMMFMMMMMMMMMMMMMMFMMLLLMMMMMMMMMMMMMMMMMMMMMMMMMMWWMSSSSMMSMSMMMMMMLLMMWWW
MWWMMMMMMMMMMMMSSSSMMMWWWMSMMMMFM!MMMMLLLMMMMMMMMMMMLB!MMLLL$LLMMLL$LLLMM!BLMMMMMMMMMMMLLLMMMM!MFMMMMSMWWWMMMSSSSMMMMMMMMMMMMWWM
MWWMMMMMMMMMMMMMSSMMMMMMMMMSMMMMMMMMML$MMLLMLLLLLMMLLLMMMMMLLLMMMMLLLMMMMMLLLMMLLLLLMLLMM$LMMMMMMMMMSMMMMMMMMMSSMMMMMMMMMMMMMWWM
WWMMMM!MMMM!MMMMMMMMMMMMFMMM$MMMMMMMMLM$MMLMLMMMMMMLLLMMLMMMMMMMMMMMMMMLMMLLLMMMMMMLMLMM$MLMMMMMMMM$MMMFMMMMMMMMMMMM!MMMM!MMMMWW
WWMMMMMMMMMMMMMMM$MMSMMMMMMMMMMMM!FMMLMMMMLMLMMMMMMLLLMMLMMLLLLMMLLLLMMLMMLLLMMMMMMLMLMMMMLMMF!MMMMMMMMMMMMSMM$MMMMMMMMMMMMMMMWW
WWWMMMMMMMMMMMM$MMSSSMMMM!MM!MMMMMMMM!LMMMMMMMMFMMMMLMMMLMTLMMMMMMMMLTMLMMMLMMMMFMMMMMMMML!MMMMMMMM!MM!MMMMSSSMM$MMMMMMMMMMMMWWW
WWWMMMMMFMM!MMMMMMMMMMFMMMMMMMFMMMMMMMLLLMMMSMMMMMMMMMMMLMMLMMMMMMMMLMMLMMMMMMMMMMMSMMMLLLMMMMMMMFMMMMMMMFMMMMMMMMMM!MMFMMMMMWWW
WWWMMMMMMMMMMMMMMMM$FFFFMMMMMMMMMMMMMMMMLMMMSSSMMMMMMMMMMMMMMMMMMMMMMMMMMMMMMMMMMSSSMMMLMMMMMMMMMMMMMMMMFFFF$MMMMMMMMMMMMMMMMWWW
MMMMMMMMMMMMMMMMWWW$FFFFMMMMMMMMMMMMMMMMLMMMSSSMMMMMMMMMMMMMMMMMMMMMMMMMMMMMMMMMMSSSMMMLMMMMMMMMMMMMMMMMFFFF$WWWMMMMMMMMMMMMMMMM
MMFMMMMMWWW!MMMMMMMMMMFMMMMMMMFMMMMMMMLLLMMMSMMMMMMMMMMMLMMLMMMMMMMMLMMLMMMMMMMMMMMSMMMLLLMMMMMMMFMMMMMMMFMMMMMMMMMM!WWWMMMMMFMM
MMMMMMMMMMMMWWW$MMMMSSSMM!MM!MMMMMMMM!LMMMMMMMMFMMMMLMMMLMTLMMMMMMMMLTMLMMMLMMMMFMMMMMMMML!MMMMMMMM!MM!MMSSSMMMM$WWWMMMMMMMMMMMM
MMMMMMMMMMMMMMMWW$MMMMMMMMMMMMSMM!FMMLMMMMLMLMMMMMMLLLMMLMMLLLLMMLLLLMMLMMLLLMMMMMMLMLMMMMLMMF!MMSMMMMMMMMMMMM$WWMMMMMMMMMMMMMMM
MMMMWW!MMMM!MMMFMMMMMMMMMMMM$MLMMMMMMMM$MMLMLMMMMMMLLLMMLMMMMMMMMMMMMMMLMMLLLMMMMMMLMLMM$MMMMMMMMLM$MMMMMMMMMMMMFMMM!MMMM!WWMMMM
LMMMMMMMMMSMMMMMMMMMSSMMMMMMMMMMMMMWWM$MMLLMLLLLLMMLLLMMMMMLLLMMMMLLLMMMMMLLLMMLLLLLMLLMM$MWWMMMMMMMMMMMMMSSMMMMMMMMMSMMMMMMMMML
MFMMMMSMWWWMMMSSSSMMMMMMMMMMMMWWM!BLMMMMMMMMMMMLLLMMMM!LLLMM$LLMMLL$MMLLL!MMMMLLLMMMMMMMMMMMLB!MWWMMMMMMMMMMMMSSSSMMMWWWMSMMMMFM
WWWMMLLMMMMMMSMSMMSSSSMWWMMMMMMMMMMMMMMMMMMMMMMMMMMLLLMMFMMMMMMMMMMMMMMFMMLLLMMMMMMMMMMMMMMMMMMMMMMMMMMWWMSSSSMMSMSMMMMMMLLMMWWW
SSSSMMMMMLTLMMWWW$SSSSMMMMMMMMMMMMMMMMMMMMMMMMMMMMMLLLTMMMMMMMMSSMMMMMMMMTLLLMMMMMMMMMMMMMMMMMMMMMMMMMMMMMSSSS$WWWMMLTLMMMMMSSSS
MMMWWW!MMMMMMMSSSSSSSMMMMLLL!MMMMMMMMSMMMMMMMMMLLMMLLLMTMMMFMMSSSSMMFMMMTMLLLMMLLMMMMMMMMMSMMMMMMMM!LLLMMMMSSSSSSSMMMMMMM!WWWMMM
LMMMMWWW?MMSSSSSSSMMMML!MMMMFMMMSMMMSSMMMMMMMMLLMMMMLMMMMMMMMSSMMSSMMMMMMMMLMMMMLLMMMMMMMMSSMMMSMMMFMMMM!LMMMMSSSSSSSMM?WWWMMMML
MMMMMMMWW$LLLMMMMLLMMMMMMMMSSMMMMMMMMMMMMMMMSSSSSSMMMM?LLL$LLLMMMMLLL$LLL?MMMMSSSSSSMMMMMMMMMMMMMMMSSMMMMMMMMLLMMMMLLL$WWMMMMMMM
MMMMMWM$SMMMMMMMMMMMMMMSSSMSSSMMMMM!LLLLLLLLLLLMMMMMLLMMFMWMMM$MM$MMMWMFMMLLMMMMMLLLLLLLLLLL!MMMMMSSSMSSSMMMMMMMMMMMMMMS$MWMMMMM
MMSMSSSSSSMMMMMMMMMMWM!MMMMMMMMMMSSSMMMWMMMMLMMFMMMLLLMLLLMLLLMMMMLLLMLLLMLLLMMMFMMLMMMMWMMMSSSMMMMMMMMMM!MWMMMMMMMMMMSSSSSSMSMM
MWMMMMMMMMMMSSSSSMSMMMMMMMMMFMMMMSSMMWWWMMMMLMMMMMMMMMMMMMMMMMMMMMMMMMMMMMMMMMMMMMMLMMMMWWWMMSSMMMMFMMMMMMMMMSMSSSSSMMMMMMMMMMWM
MWWMMMMMMMMMMMSSSSMMMMMMMMMFMFMMMMMMMMWMMMMMLLMFMLLSSMLLLLMMMMMMMMMMMMLLLLMSSLLMFMLLMMMMMWMMMMMMMMFMFMMMMMMMMMSSSSMMMMMMMMMMMWWM
MMMWWM!M!!MMMMSMMMMMMMMMMMMMFMMMMMMMMMMMMFMMMLLMLLSSMMMMMLLLLMMMMMMLLLLMMMMMSSLLMLLMMMFMMMMMMMMMMMMFMMMMMMMMMMMMMSMMMM!!M!MWWMMM
MMMMMMMMMWWS!MMMMMMMMMMMMMMMMMMMMMMMMMM!!!!MMMLLLMSMMMMMMMMLMMMMMMMMLMMMMMMMMSMLLLMMM!!!!MMMMMMMMMMMMMMMMMMMMMMMMMM!SWWMMMMMMMMM
MMMMMMMMMMMMMMMMMMMMWWMMMMMMMMMMMWWWWWWS!B!LMMMMMMMSSMMMMMMM$MMMMMM$MMMMMMMSSMMMMMMML!B!SWWWWWWMMMMMMMMMMMWWMMMMMMMMMMMMMMMMMMMM
MMMWWMWMMMMMMMWWWWWWWWM$MMMMMMM!MMMMMMMWM!!!MMMMMSSMMMMMMMMLMLMLLMLMLMMMMMMMMSSMMMMM!!!MWMMMMMMM!MMMMMMM$MWWWWWWWWMMMMMMMWMWWMMM
MMMMMMMMMMMWWWWMMMMWWWWWWWMWWM!!MMMMMMHWW!!MMMMMMMMMMMSMMMMLMLMLLMLMLMMMMSMMMMMMMMMMM!!WWHMMMMMM!!MWWMWWWWWWWMMMMWWWWMMMMMMMMMMM
MMMMMMMMMMWWMWWMMWMWWMWWWWWWW!!MWWWW$MMMMMMMMMMMMMMMMMMMMMM!MMMMMMMM!MMMMMMMMMMMMMMMMMMMMMM$WWWWM!!WWWWWWWMWWMWMMWWMWWMMMMMMMMMM
MMMMMMMMMWWWWWWWWWWWWWWW!MMMMMMMMMMMMMMMWWWMMMM!MMMMMMMMMM!MMMMMMMMMM!MMMMMMMMMM!MMMMWWWMMMMMMMMMMMMMMM!WWWWWWWWWWWWWWWMMMMMMMMM
MMMMMMMMMMWWWMWWWWWWWWM!$MMMSMSSMMMMMMMMWWMMMM!!MMMMMM!MMMMFMMMMMMMMFMMMM!MMMMMM!!MMMMWWMMMMMMMMSSMSMMM$!MWWWWWWWWMWWWMMMMMMMMMM
MMMMMMMMMWWWMWWWWWWWWW!$!!MMMMMMMMMMSSSSMMMMMMMMMWWMM!!!MMMMMMMMMMMMMMMM!!!MMWWMMMMMMMMMSSSSMMMMMMMMMM!!$!WWWWWWWWWMWWWMMMMMMMMM
MMMMMMWMWWWWWWWWWWW!SMMMMMMMMMWWMMMMMMMM$MMMMMMMMMMMMMMMMFMMMS!!!!SMMMFMMMMMMMMMMMMMMMM$MMMMMMMMWWMMMMMMMMMS!WWWWWWWWWWWMWMMMMMM
FMMMMMMMWWWWWWWWWWMM!MMMMMFMWMMMMMMM$MMMMMMMMMMSSMMM!MMMM!MMMM!MM!MMMM!MMMM!MMMSSMMMMMMMMMM$MMMMMMMWMFMMMMM!MMWWWWWWWWWWMMMMMMMF
MMWWMMMMMMMMSMMMMMMMMMMWWMMMMMMMMMMMMMMMMWWWWWMWWWWMM!MM!D!MMMMMMMMMM!D!MM!MMWWWWMWWWWWMMMMMMMMMMMMMMMMWWMMMMMMMMMMSMMMMMMMMWWMM
MMMMMWWMMMMMMMMSMMMMMMMMMFWWMMMWMMMMMMMMMMMMWWWWWWWWWWMM!!MMMMMMMMMMMM!!MMWWWWWWWWWWMMMMMMMMMMMMWMMMWWFMMMMMMMMMSMMMMMMMMWWMMMMM
MMMMMMMWMMMMMSMMMMMMMMMMWWMMWMMMMMMMMMMMMWMWWWWWWMWMM!MMMMMFMMMMMMMMFMMMMM!MMWMWWWWWWMWMMMMMMMMMMMMWMMWWMMMMMMMMMMSMMMMMWMMMMMMM
MMMMMWWWWMWWWMMMMFMMMSMWWMMWWFMMMMMMMMSMMMMWWWWWMMMMMMMMMMMMMMMMMMMMMMMMMMMMMMMMWWWWWMMMMSMMMMMMMMFWWMMWWMSMMMFMMMMWWWMWWWWMMMMM
LLWM!MMMMMSMSMMMMWWMMWMMSSMMMMMMWWWWWWWMW!WWWWWWWWMMMMMMMMMMMMMMMMMMMMMMMMMMMMWWWWWWWW!WMWWWWWWWMMMMMMSSMMWMMWWMMMMSMSMMMMM!MWLL
WWMWMMMSSMMMFWWMMMMMSMMMMMWWMWMWWWWWWMDDWM!WWMWWWWMMFMMMMMMMMMMMMMMMMMMMMMMFMMWWWWMWW!MWDDMWWWWWWMWMWWMMMMMSMMMMMWWFMMMSSMMMWMWW
WWWWWWMMSMMMMMWWMMMMMSSMMMMWMWWWWWWWWWWMDWM!MMMWWWMMMMMMMMMMMMMMMMMMMMMMMMMMMMWWWMMM!MWDMWWWWWWWWWWMWMMMMSSMMMMMWWMMMMMSMMWWWWWW
MWMMWWWMWWMMWWWMWMMMMMMMMMWWMFMSMMSMMWWWWWWMMMMMWWWWMMMMMMMMFMMWWMMFMMMMMMMMWWWWMMMMMWWWWWWMMSMMSMFMWWMMMMMMMMMWMWWWMMWWMWWWMMWM
MWMWWWWWWWWWWWWWWM!MMMMMMMWWMMMMMMMMWWWWWMMMMMMMMWWWWWWWWMMMMWWWWWWMMMMWWWWWWWWMMMMMMMMWWWWWMMMMMMMMWWMMMMMMM!MWWWWWWWWWWWWWWMWM
WWWWWWWWWWWWWWWMM!!!!MMMMMWWWWWWWWWWWWWMMMMMMMMMMMMWWWWWWWWWWWWWWWWWWWWWWWWWWMMMMMMMMMMMMWWWWWWWWWWWWWMMMMM!!!!MMWWWWWWWWWWWWWWW
MMWWWWWWWWWWWWWWWWM$M!MMWLWWWWWWMWWWWWWMMMMMMMMMMMFMMWWWWWWWWWWWWWWWWWWWWWWMMFMMMMMMMMMMMWWWWWWMWWWWWWLWMM!M$MWWWWWWWWWWWWWWWWMM
WWWWWWWWWWWWWWLLLLLMMMLWWWMWWWMMWWWMMMMMMMMMMMMMMMMMMMMMWMWMMMMMMMMMMWMWMMMMMMMMMMMMMMMMMMMMMWWWMMWWWMWWWLMMMLLLLLWWWWWWWWWWWWWW
MWWWMWWWWWWWWHMMMMMMMLWWWWWLWWMMMMMMMMMMFMMMMMMMMMMMMMMMMMMMMMMMMMMMMMMMMMMMMMMMMMMMMMMFMMMMMMMMMMWWLWWWWWLMMMMMMMHWWWWWWWWMWWWM
MMMMMMMMMMMMMMMMMMMMMMMMWWWLLLLLLLWWWWWMMWWMWWWM!MMMMMMMMMMMMMMMMMMMMMMMMMMMMMM!MWWWMWWMMWWWWWLLLLLLLWWWMMMMMMMMMMMMMMMMMMMMMMMM
MMMMMMMMMMMMMMMMMMMMMMMMMWWWWWWWWWWWWWWWWWWWWWWW!MMMMMWWMMMMMMMMMMMMMMMMWWMMMMM!WWWWWWWWWWWWWWWWWWWWWWWMMMMMMMMMMMMMMMMMMMMMMMMM
WWMWWWWMSWWWWWWWWWMWWWWMMMMMMMWMMMMMWMMMMMMMMMMMMMMMMMMMMMMSSSSSSSSSSMMMMMMMMMMMMMMMMMMMMMMWMMMMMWMMMMMMMWWWWMWWWWWWWWWSMWWWWMWW
MMMFMMMMMMMMMMMMMMMMMWMWWWWWWWWWWWWSMSSWWWWW!MMMMMMMMMMSSSSSSSMMMMSSSSSSSMMMMMMMMMM!WWWWWSSMSWWWWWWWWWWWWMWMMMMMMMMMMMMMMMMMFMMM
WMWWWSMSSWWWWWWWWWWWMFFMMMMMMWMWMWWMMMMMMMMMMMMMMMWMMMMSMSSSMMFMMFMMSSSMSMMMMWMMMMMMMMMMMMMMMWWMWMWMMMMMMFFMWWWWWWWWWWWSSMSWWWMW
MMMMMMMWWWMMWMMMMMFWFFWWWWWWWWWWWWSSSWWWWW!MMMMMMMWMMMMSSSSSMMMMMMMMSSSSSMMMMWMMMMMMM!WWWWWSSSWWWWWWWWWWWWFFWFMMMMMWMMWWWMMMMMMM
MMWWMWWWWWWWWWWWWWWWWWWFMMMFMMMMWWWMMMMMMMMMMMMMMMMMMMMMMSSSMMMMMMMMSSSMMMMMMMMMMMMMMMMMMMMMMWWWMMMMFMMMFWWWWWWWWWWWWWWWWWWMWWMM
MWWWWWMWWWWWWWWWLWWWWWMMMMMMMMMMMMMMMMMMMMMMMWMMMMMWWWSSMMSSMMMMMMMMSSMMSSWWWMMMMMWMMMMMMMMMMMMMMMMMMMMMMMWWWWWLWWWWWWWWWMWWWWWM
MWWMWWWWWWWWWWWWWWMWWWFFMMMMMMMMMMMMMMMMSMMMMWMMMMMWMSSMMMMSSSMMMMSSSMMMMSSMWMMMMMWMMMMSMMMMMMMMMMMMMMMMFFWWWMWWWWWWWWWWWWWWMWWM
MWWMWWWWWWWWWWWWWWWWWWFMMMMMMMMMMMFLLLLLSSSMMWMMMMWWMSMMFMMSSSMMMMSSSMMFMMSMWWMMMMWMMSSSLLLLLFMMMMMMMMMMMFWWWWWWWWWWWWWWWWWWMWWM
LMMMMMMMMMMMMWWWMWWWWWWWWWWWSSWWWWWM$M$LMMMMWWMMMMWMMSMMMMSSMMMMMMMMSSMMMMSMMWMMMMWWMMMML$M$MWWWWWSSWWWWWWWWWWWMWWWMMMMMMMMMMMML
MLMMMMMMMMMMMWWWWWWWWWWLLWWWWSSSSWWWM?M!!MMMWWWMMMMMMSMMSSSMMMMMMMMMMSSSMMSMMMMMMWWWMMM!!M?MWWWSSSSWWWWLLWWWWWWWWWWMMMMMMMMMMMLM
LMMMSMMMMWWMWMWWWWWWWWLLWWWWSSWSWWWM$M$LLLLMMSSSSMMSMMWWWWMMMML!!LMMMMWWWWMMSMMSSSSMMLLLL$M$MWWWSWSSWWWWLLWWWWWWWWMWMWWMMMMSMMML
SSWWM?MMMLMMSMMSSSSWWWWWWMMMMLLLLLMMSSMMFMWWWWWWWWWWWWWWWWWSSSM!!MSSSWWWWWWWWWWWWWWWWWMFMMSSMMLLLLLMMMMWWWWWWSSSSMMSMMLMMM?MWWSS
WWMMMMSSMMWWWWWWWWMWWWWWWWWMMMMMSSSMMMMMMMMWWWWWMMMMMMMMMSMLMLLLLLLMLMSMMMMMMMMMWWWWWMMMMMMMMSSSMMMMMWWWWWWWWMWWWWWWWWMMSSMMMMWW
WWWWWWMMMSSSSSSMMMMMMMWMWWWWWWWWWWWWWMLMMSSSMMMW?MMMMMLMMSSLMLMMMMLMLSSMMLMMMMM?WMMMSSSMMLMWWWWWWWWWWWWWMWMMMMMMMSSSSSSMMMWWWWWW
WWWSSMSMMMMWWWWWWWWWWWMWWWMMMMSSSSSSSMMMMMMMMWWMMMMMMMLMMSSLMLMDDMLMLSSMMLMMMMMMMWWMMMMMMMMSSSSSSSMMMMWWWMWWWWWWWWWWWMMMMSMSSWWW
MWWWLWMWWWWWMMMMMMMWWW$MWWMMMMSSSSMMMMMMMMMMMMMMMMMMLLTMMSMLMLMMMMLMLMSMMTLLMMMMMMMMMMMMMMMMMMSSSSMMMMWWM$WWWMMMMMMMWWWWWMWLWWWM
LLMLMSMMMMMLLMMMMMMMMMMMFMMMMMMMMMMMWWMWWWWWWWWMWMWWMMMMMMMWWWM!!MWWWMMMMMMMWWMWMWWWWWWWWMWWMMMMMMMMMMMFMMMMMMMMMMMLLMMMMMSMLMLL
MSMLMMMMMLMMMMSSSMMMMMMMMMMMMWMMWWWWWWWWWWWWWWMWWWMMMMMWMWM!!MM!!MM!!MWMWMMMMMWWWMWWWWWWWWWWWWWWMMWMMMMMMMMMMMMSSSMMMMLMMMMMLMSM
LLMMSSSSMMMMMMMWWWWWWWWMWWWWWWMWWWWWWWWWWWMWWWWWM!MMMLLMMSMLLLLLLLLLLMSMMLLMMM!MWWWWWMWWWWWWWWWWWMWWWWWWMWWWWWWWWMMMMMMMSSSSMMLL
MWWWWWWWMWWMWWMWWWWWWWWWWWWMMWWWWMMMMMMSSSMMMMLMFMLLLMMMSSMMMMMMMMMMMMSSMMMLLLMFMLMMMMSSSMMMMMMWWWWMMWWWWWWWWWWWWMWWMWWMWWWWWWWM
WWMWWMMMWMWWMWWWWWMWWMWWWWWWWWWWWMMMMMSSMMMMMLLMFFMMLMMSSSMSSMMMMMMSSMSSSMMLMMFFMLLMMMMMSSMMMMMWWWWWWWWWWWMWWMWWWWWMWWMWMMMWWMWW
MLLMMMMMMMMWWWWWWWWWWWWWWMMMMWWMMMMMMMMMMMMMMWM$$F?MMMMSMSSSSSSMMSSSSSSMSMMMM?F$$MWMMMMMMMMMMMMMMWWMMMMWWWWWWWWWWWWWWMMMMMMMMLLM
