 ~              ~~    ~~~~~~~~~~~~~~        || $$F?    # ######  ###### #    ?F$$ ||        ~~~~~~~~~~~~~~    ~~              ~ 
~~ ~~   ~ ~~ ~~~~~ ~~ ~~~~~~~~~~~     ##     || FF  |  ### ##      ## ###  |  FF ||     ##     ~~~~~~~~~~~ ~~ ~~~~~ ~~ ~   ~~ ~~
 ~~~~~~~ ~~ ~~ ~~~~~~~~~~~~  ~~~~      ###    | F |||   ##            ##   ||| F |    ###      ~~~~  ~~~~~~~~~~~~ ~~ ~~ ~~~~~~~ 
 ~~~~~ ~~~~~~~~~~~ ~~~~~~ ~~~~~~~~       ####  ||!   ||  # |||||||||| #  ||   !||  ####       ~~~~~~~~ ~~~~~~ ~~~~~~~~~~~ ~~~~~ 
 ~ ~     ~~~ ~~~~~~~~~~~~~~  ~            ###    |     | # !!  !!  !! # |     |    ###            ~  ~~~~~~~~~~~~~~ ~~~     ~ ~ 
 ~~~       ~~ ~ ~~~~~~~~ ~~           F           ||     # | ||!!|| | #     ||           F           ~~ ~~~~~~~~ ~ ~~       ~~~ 
~~~       ~~~~~ ~|~~~ $ ~~    ####                  ||T  # | |    | | #  T||                  ####    ~~ $ ~~~|~ ~~~~~       ~~~
~~~## #    ~~~~~~~~~~~ ~~~    #######        ~~       |  ##| | DD | |##  |       ~~        #######    ~~~ ~~~~~~~~~~~    # ##~~~
~   ###  | ~~~~~~~~~~~~~ ~       ######   ~~~~~~?     |  ##| |    | |##  |     ?~~~~~~   ######       ~ ~~~~~~~~~~~~~ |  ###   ~
~~    ##  ~~~~~~~~ ~~~~~~~~     ###        ~~~~~         # | |||||| | #         ~~~~~        ###     ~~~~~~~~ ~~~~~~~~  ##    ~~
 ~~##? ###~~~~~~~~~~~~~~~~~ F  ##  |||||    ~~~~~~####  #  |   !!   |  #  ####~~~~~~    |||||  ##  F ~~~~~~~~~~~~~~~~~### ?##~~ 
 ~~~#~##~~~~||~~~~~~~~ ~ ~~    #   |$ $|    ~~~~  #  ####  ||||!!||||  ####  #  ~~~~    |$ $|   #    ~~ ~ ~~~~~~~~||~~~~##~#~~~ 
 ~~~####~~~~||~~~~~~~~~~           | ? !!   ~~~      #  ###          ###  #      ~~~   !! ? |           ~~~~~~~~~~||~~~~####~~~ 
 ~~~~~##~~~~~~~~~~~ ~~~            |$ $|    ~~    ~  #    ##  TTTT  ##    #  ~    ~~    |$ $|            ~~~ ~~~~~~~~~~~##~~~~~ 
 ~~ ~~~~~~~~~~~~~~~~~~F           F|||||###  ~    ~~ #  F  ###    ###  F  # ~~    ~  ###|||||F           F~~~~~~~~~~~~~~~~~~ ~~ 
 ~~ ~~~~~~~~~~~~~~ ~~~FF                #    ~     ~ ##    ###    ###    ## ~     ~    #                FF~~~ ~~~~~~~~~~~~~~ ~~ 
 ~~~~~ ~~~~~~~~~|~~~~~                       ~     ~~~##  ##        ##  ##~~~     ~                       ~~~~~|~~~~~~~~~ ~~~~~ 
  ~~ ~~~~~~~~~~~~~~~~~~F   F    ~~~                     ###        ###                      ~~~    F   F~~~~~~~~~~~~~~~~~~ ~~  
~~~~~###~~~~~~~~~~~~FF~F     ~  ~~~       !       ~    #####        #####    ~       !       ~~~  ~     F~FF~~~~~~~~~~~~###~~~~~
~ ~~~# ##~~~~~~~~~~~ FF      ~ ~ ~~               ~    # ###  F  F  ### #    ~               ~~ ~ ~      FF ~~~~~~~~~~~## #~~~ ~
~~~~~## #~~~~~~~~~~~~ ~                 F   !          #######    #######          !   F                 ~ ~~~~~~~~~~~~# ##~~~~~
~~ ~~~~ #~~~~~~~~~ ~~~~       ~     ~                      ##########                      ~     ~       ~~~~ ~~~~~~~~~# ~~~~ ~~
~~~~~~~~~~~~~~~~~~~~~~~                         !     ~~                ~~     !                         ~~~~~~~~~~~~~~~~~~~~~~~
 ~~~ ~~  ~~~~~|||||||~~~                        !                              !                        ~~~|||||||~~~~~  ~~ ~~~ 
 ~~~ ~~~~~~~~S       |~~~~~|~~          F                                              F          ~~|~~~~~|       S~~~~~~~~ ~~~ 
~~~~~~~~~~~~~~|||||   |~~~ ~~~  ~~~                     ~S~          ~B~                     ~~~  ~~~ ~~~|   |||||~~~~~~~~~~~~~~
 ~~~~~~~~~~~~~~~~  $ !  ~|~~~~~~ ~~~~~~           F  ~~~~~~~~~~~~~~~~~~~~~~  F           ~~~~~~ ~~~~~~|~  ! $  ~~~~~~~~~~~~~~~~ 
  ~~~~~~~~~~~~~~~!!!!     ~~~~~~~~~~~~~            ~~~~~~~~~~~~~~~~~~~~~~~~~~            ~~~~~~~~~~~~~     !!!!~~~~~~~~~~~~~~~  
 ~~~~~~~~~~~~~~ ~ !       ~~        ~~~~~        ~~~~~~~~    ~~~~~~    ~~~~~~~~        ~~~~~        ~~       ! ~ ~~~~~~~~~~~~~~ 
 ~  ~~~ ~~  ~~~ ~         ~~ F #  #  ~~~~~~     ~~~~        F  ~~  F        ~~~~     ~~~~~~  #  # F ~~         ~ ~~~  ~~ ~~~  ~ 
 |||~~~~~~~~~~ ~    ##     ~~     #  ~~~~~~!   ~~~                            ~~~   !~~~~~~  #     ~~     ##    ~ ~~~~~~~~!|||~ 
 |D!!!~~~~~ ~ ~~     #     ~~F   ##   ~ ~~!~~ ~~~~  F                      F  ~~~~ ~~!~~ ~   ##   F~~     #     ~~ ~ ~~~~!!!!D~ 
 |||!~ ~~~~~~~      ##  ~  ~~    # #     !~~~~~~~~                            ~~~~~~~~!     # #    ~~  ~  ##      ~~~~~~~ !|||~ 
     ~~~~ ~~~    F   # ~~  ~~F        #    ~~~~~                                ~~~~~    #        F~~  ~~ #   F    ~~~ ~~~~     
  ~ ~~~~~~ ~            ~  ~~          #     ~       ! !!!!F        F     !       ~     #          ~~  ~            ~ ~~~~~~ ~  
  ~~~~~~~~~~            ~   ~~F         #        ~~   !!!!!!!         !!     ~~        #         F~~   ~            ~~~~~~~~~~  
  ~~~~ ~~~~~                ~~          #        ~~  !!!!D!!!        !$!  !  ~~        #          ~~                ~~~~~ ~~~~  
  ~~~~~~~~~~       F!       ~ F     $   ##          ! !!!!!!! !  !    !    !          ##   $     F ~       !F       ~~~~~~~~~~  
~~~~~~~~~~~ ~      !        ~~         #$#   F         !!!!!  !!!!                F   #$#         ~~        !      ~ ~~~~~~~~~~~
~~~~~~~~~ ~~~         !$!!  ~~         ####          !!!                !!!          ####         ~~  !!$!         ~~~ ~~~~~~~~~
 ~~~~~~~~ ~~~          !$    ~~        ## #   !!      !    F        F    !      !!   # ##        ~~    $!          ~~~ ~~~~~~~~ 
~~~~~~~~~~~~~~~         !    ~~~               !          !          !          !               ~~~    !         ~~~~~~~~~~~~~~~
~~~~~~~ ~~ ~  ~~ ~~          !!~~~~ $                      !        !                      $ ~~~~!!          ~~ ~~  ~ ~~ ~~~~~~~
 ~~ ~~~~~~~    ~~~~           !!~~S      !!           #    | | || | |    #           !!      S~~!!           ~~~~    ~~~~~~~ ~~ 
 ~~~~~~~~       ~ ~~   $       ! ~       !!!     ##        | | || | |        ##     !!!       ~ !       $   ~~ ~       ~~~~~~~~ 
#~~~~~~           ~~                    !B!       ##       |$      $|       ##       !B!                    ~~           ~~~~~~#
#~~         !                          !!!!   ||| #        |        |        # |||   !!!!                          !         ~~#
 ~~   ! !!    #             F            F   || ||##     ||||      ||||     ##|| ||   F            F             #    !! !   ~~ 
 ~~           ####         F F        ~     || F ||## ||||            |||| ##|| F ||     ~        F F         ####           ~~ 
 ~          ##### #         F    ##  ~~~    |                                      |    ~~~  ##    F         # #####          ~ 
 ~          ###### #  !          ###   ~    |  F   ||| ||| |||    ||| ||| |||   F  |    ~   ###          !  # ######          ~ 
 ~     $     ### ###              #!   ~ F  ||     |||||||||||$  $|||||||||||     ||  F ~   !#              ### ###     $     ~ 
~~       $    ######               ##        ||    |||?|||$|||    |||$|||?|||    ||        ##               ######    $       ~~
~~~    |?|    #######  !    F   #   ##        ||    |        ##  ##        |    ||        ##   #   F    !  #######    |?|    ~~~
~~~   !|||    #######       !        #         ||  ||| T   F  ####  F   T |||  ||         #        !       #######    |||!   ~~~
~~~  |T|     ####$####                             |||T        ##        T|||                             ####$####     |T|  ~~~
~~~  ||      # #  #### ~~                          |||  F              F  |||                          ~~ ####  # #      ||  ~~~
 ~~            ####   ~~~ #    F !    |||           |B!  |||$||  ||$|||  !B|           |||    ! F    # ~~~   ####            ~~ 
 ~~             ##         #         |$  || |||||  |||     |||    |||     |||  ||||| ||  $|         #         ##             ~~ 
~~    !    !            F   $        | $  | |      |||  |              |  |||      | |  $ |        $   F            !    !    ~~
~~               $  #            !F  |    | |      |||  |  ||||  ||||  |  |||      | |    |  F!            #  $               ~~
~~~            $  ###    !  !        !|        F    |   | T|        |T |   |    F        |!        !  !    ###  $            ~~~
~~~     F  !          F       F       |||   #           |  |        |  |           #   |||       F       F          !  F     ~~~
~~~                $FFFF                |   ###                @                 ###   |                FFFF$                ~~~
                ~~~$FFFF                |   ###                                  ###   |                FFFF$~~~                
  F     ~~~!          F       F       |||   #           |  |        |  |           #   |||       F       F          !~~~     F  
            ~~~$    ###  !  !        !|        F    |   | T|        |T |   |    F        |!        !  !  ###    $~~~            
               ~~$            #  !F  |    | |      |||  |  ||||  ||||  |  |||      | |    |  F!  #            $~~               
    ~~!    !   F            $ |        $  | |      |||  |              |  |||      | |  $        | $            F   !    !~~    
|         #         ##             ~~ $  || |||||  |||     |||    |||     |||  ||||| ||  $ ~~             ##         #         |
 F    # ~~~   ####            ~~ !B|           |||    !|||  $||  ||$  |||!    |||           |B! ~~            ####   ~~~ #    F 
~~~  ||      # #  #### ~~                          |||  F              F  |||                          ~~ ####  # #      ||  ~~~
####     |T|  ~~~$####                             |||T        ##        T|||                             ####$~~~  |T|     ####
   ~~~!       #######    |||!        #         ||  ||| T   F  ####  F   T |||  ||         #        !|||    #######       !~~~   
|    ~~~?  #######    |!    F   #   ##        ||    |        ##  ##        |    ||        ##   #   F    !|    #######  ?~~~    |
       ~~$|||    ||        ##               ######    ?|||$|||    |||$|||?    ######               ##        ||    |||$~~       
     ~ $#              ### ###     !|||||||||||     ||  F ~   $  $   ~ F  ||     |||||||||||!     ### ###              #$ ~     
  # ######          ~ !          ###   ~    |  F   ||| ||| |||    ||| ||| |||   F  |    ~   ###          ! ~          ###### #  
 ~          ##### #         F    ##  ~~~    |                                      |    ~~~  ##    F         # #####          ~ 
 ~~           ####         F F        ~     || F ||## ||||            |||| ##|| F ||     ~        F F         ####           ~~ 
   ~~ ! !!    #             F            F   || ||##     ||||      ||||     ##|| ||   F            F             #    !! ! ~~   
         ~~#!                          !!!!   ||| #        |        |        # |||   !!!!                          !#~~         
                    ~~           ~~~~~~#!B!|       ##       $      $       ##       |!B!#~~~~~~           ~~                    
   ~~ ~       ~~~~~~~~ $       !       ~ !!!     ##        | | || | |        ##     !!! ~       !       $ ~~~~~~~~       ~ ~~   
           ~~~~    ~~~~~~~ ~~ !!      S~~!!           #    | | || | |    #           !!~~S      !! ~~ ~~~~~~~    ~~~~           
          ~~ ~~  ~ ~~ ~~~~~~~!! ~~~~$                      !        !                      $~~~~ !!~~~~~~~ ~~ ~  ~~ ~~          
         ~~~~~~~~~~~~~~~!               ~~~    !          !          !          !    ~~~               !~~~~~~~~~~~~~~~         
          ~~~ ~~~~~~~~ !$   # ##        ~~    !!      !    F        F    !      !!    ~~        ## #   $! ~~~~~~~~ ~~~          
         ~~~ ~~~~~~~~~!$!!          ####         ~~  !!!                !!!  ~~         ####          !!$!~~~~~~~~~ ~~~         
      ~ ~~~~~~~~~~~!#         ~~        $                F   #!!!!#   F                $        ~~         #!~~~~~~~~~~~ ~      
F       ~~~~~~~~~~  !     F ~       $          ##   !    !    !  ! !!|||   !   ##          $       ~ F     !  ~~~~~~~~~~       F
  ~~        #          ~~                ~~~~~ ~~~~  !  !$!       !!!!D|  !  ~~~~ ~~~~~                ~~          #        ~~  
     ~~        #         F~~   ~            ~~~~~~~~~~  !!         !!|||  ~~~~~~~~~~            ~   ~~F         #        ~~     
       ~     #          ~~  ~            ~ ~~~~~~ ~  !     F        F     !  ~ ~~~~~~ ~            ~  ~~          #     ~       
     ~~~~ ~~~    F   # ~~  ~~F        #    ~~~~~                                ~~~~~    #        F~~  ~~ #   F    ~~~ ~~~~     
||~ !     # #    ~~  ~  ##      ~~~~~~~ ~!~~~~~~~~                            ~~~~~~~~!~ ~~~~~~~      ##  ~  ~~    # #     ! ~||
~~ ~   ##   F~~     #     ~~ ~ ~~~~~~ DD~ !~~ ~~~~  F                      F  ~~~~ ~~! ~DD ~~~~~~ ~ ~~     #     ~~F   ##   ~ ~~
~~~~~~  #     ~~     ##    ~ ~~~~~~~~~~ D~ !   ~~~                            ~~~   ! ~D ~~~~~~~~~~ ~    ##     ~~     #  ~~~~~~
 ~  ~~~ ~~  ~~~ ~         ~~ F #  #  ~~~~~~     ~~~~        F  ~~  F        ~~~~     ~~~~~~  #  # F ~~         ~ ~~~  ~~ ~~~  ~ 
 ~ ~~~~~~~~~~~~~~ !       ~~        ~~~~~        ~~~~~~~~ B  ~~~~~~  S ~~~~~~~~        ~~~~~        ~~       ! ~~~~~~~~~~~~~~ ~ 
~~~~~~~~~~~~~~~  !!!!     ~~~~~~~~~~~~~            ~~~~~~~~~~~~~~~~~~~~~~~~~~            ~~~~~~~~~~~~~     !!!!  ~~~~~~~~~~~~~~~
  ~~~~~~~~~~~~~~~~ $ !  ~|~~~~~~ ~~~~~~           F  ~~~~~~~~~~~~~~~~~~~~~~  F           ~~~~~~ ~~~~~~|~  ! $ ~~~~~~~~~~~~~~~~  
~~~~~~~~~~~~~~|||||   |~~~ ~~~  ~~~                     ~ ~          ~ ~                     ~~~  ~~~ ~~~|   |||||~~~~~~~~~~~~~~
 ~~~ ~~~~~~~~S       |~~~~~|~~          F                                              F          ~~|~~~~~|       S~~~~~~~~ ~~~ 
                        ~~~|||||||~~~~~  ~~ ~~~ !                              ! ~~~ ~~  ~~~~~|||||||~~~                        
                         ~~~~~~~~~~~~~~~~~~~~~~~!     ~~                ~~     !~~~~~~~~~~~~~~~~~~~~~~~                         
~~ ~~~~ #~~~~~~~~~ ~~~~       ~     ~                      ##########                      ~     ~       ~~~~ ~~~~~~~~~# ~~~~ ~~
   F                 ~ ~~~~~~~~~~~~# ##~~~~~!          #######    #######          !~~~~~## #~~~~~~~~~~~~ ~                 F   
~ ~~~# ##~~~~~~~~~~~ FF      ~ ~ ~~               ~    # ###  F  F  ### #    ~               ~~ ~ ~      FF ~~~~~~~~~~~## #~~~ ~
       ~~~  ~     F~FF~~~~~~~~~~~~###~~~~~!       ~    #####        #####    ~       !~~~~~###~~~~~~~~~~~~FF~F     ~  ~~~       
  ~~ ~~~~~~~~~~~~~~~~~~F   F    ~~~                      ###        ###                      ~~~    F   F~~~~~~~~~~~~~~~~~~ ~~  
 ~~~~~ ~~~~~~~~~|~~~~~                       ~     ~~~##  ##        ##  ##~~~     ~                       ~~~~~|~~~~~~~~~ ~~~~~ 
 ~~ ~~~~~~~~~~~~~~ ~~~FF                #    ~     ~ ##    ###    ###    ## ~     ~    #                FF~~~ ~~~~~~~~~~~~~~ ~~ 
 ~~ ~~~~~~~~~~~~~~~~~~F           F|||||###  ~    ~~ #  F  ###    ###  F  # ~~    ~  ###|||||F           F~~~~~~~~~~~~~~~~~~ ~~ 
|            ~~~ ~~~~~~~~~~~##~~~~~ $ $|    ~~    ~  #    ##        ##    #  ~    ~~    |$ $ ~~~~~##~~~~~~~~~~~ ~~~            |
 |           ~~~~~~~~~~||~~~~####~~~ ? !!   ~~~      #  ###          ###  #      ~~~   !! ? ~~~####~~~~||~~~~~~~~~~           | 
|   #    ~~ ~ ~~~~~~~~||~~~~##~#~~~ $ $||||  ####  #  ~~~~    |!!|    ~~~~  #  ####  ||||$ $ ~~~#~##~~~~||~~~~~~~~ ~ ~~    #   |
##~~ ?   |  #  ####~~~~~~    |||||  ##  F ~~~~~~~~~~~~~~~~~### !! ###~~~~~~~~~~~~~~~~~ F  ##  |||||    ~~~~~~####  #  |   ? ~~##
~~    ##  ~~~~~~~~ ~~~~~~~~     ###        ~~~~~         # | |||||| | #         ~~~~~        ###     ~~~~~~~~ ~~~~~~~~  ##    ~~
~~~~~~   ######       ~ ~~~~~~~~~~~~~ |  ###   ~?     |  ##| |    | |##  |     ?~   ###  | ~~~~~~~~~~~~~ ~       ######   ~~~~~~
~~~## #    ~~~~~~~~~~~ ~~~    #######        ~~       |  ##| | DD | |##  |       ~~        #######    ~~~ ~~~~~~~~~~~    # ##~~~
 ~~~|~ ~~~~~       ~~~$ ~~    ####                  ||T  # | |    | | #  T||                  ####    ~~ $~~~       ~~~~~ ~|~~~ 
|| | #     ||           F           ~~ ~~~~~~~~ ~ ~~       ~~~ !! ~~~       ~~ ~ ~~~~~~~~ ~~           F           ||     # | ||
 # |     |    ###            ~  ~~~~~~~~~~~~~~ ~~~     ~ ~ !!  !!  !! ~ ~     ~~~ ~~~~~~~~~~~~~~  ~            ###    |     | # 
||  ####       ~~~~~~~~ ~~~~~~ ~~~~~~~~~~~ ~~~~~ !   ||  # |||||||||| #  ||   ! ~~~~~ ~~~~~~~~~~~ ~~~~~~ ~~~~~~~~       ####  ||
 ~~~~~~~ ~~ ~~ ~~~~~~~~~~~~  ~~~~      ###    | F |||   ##            ##   ||| F |    ###      ~~~~  ~~~~~~~~~~~~ ~~ ~~ ~~~~~~~ 
~~ ~~   ~ ~~ ~~~~~ ~~ ~~~~~~~~~~~     ##     || FF  |  ### ##      ## ###  |  FF ||     ##     ~~~~~~~~~~~ ~~ ~~~~~ ~~ ~   ~~ ~~
 ||        ~~~~~~~~~~~~~~    ~~              ~ $$F?    # ######  ###### #    ?F$$ ~              ~~    ~~~~~~~~~~~~~~        || 
