 W              WW    WWWWWWWWWWWWWW        LL $$F?    S SSSSSS  SSSSSS S    ?F$$ LL        WWWWWWWWWWWWWW    WW              W 
WW WW   W WW WWWWW WW WWWWWWWWWWW     SS     LL FF  L  SSS SS      SS SSS  L  FF LL     SS     WWWWWWWWWWW WW WWWWW WW W   WW WW
 WWWWWWW WW WW WWWWWWWWWWWW  WWWW      SSS    L F LLL   SS            SS   LLL F L    SSS      WWWW  WWWWWWWWWWWW WW WW WWWWWWW 
 WWWWW WWWWWWWWWWW WWWWWW WWWWWWWW       SSSS  LL!   LL  S LLLLLLLLLL S  LL   !LL  SSSS       WWWWWWWW WWWWWW WWWWWWWWWWW WWWWW 
 W W     WWW WWWWWWWWWWWWWW  W            SSS    L     L S !!  !!  !! S L     L    SSS            W  WWWWWWWWWWWWWW WWW     W W 
 WWW       WW W WWWWWWWW WW           F           LL     S L LL!!LL L S     LL           F           WW WWWWWWWW W WW       WWW 
WWW       WWWWW WLWWW $ WW    SSSS                  LLT  S L L    L L S  TLL                  SSSS    WW $ WWWLW WWWWW       WWW
WWWSS S    WWWWWWWWWWW WWW    SSSSSSS        WW       L  SSL L DD L LSS  L       WW        SSSSSSS    WWW WWWWWWWWWWW    S SSWWW
W   SSS  L WWWWWWWWWWWWW W       SSSSSS   WWWWWW?     L  SSL L    L LSS  L     ?WWWWWW   SSSSSS       W WWWWWWWWWWWWW L  SSS   W
WW    SS  WWWWWWWW WWWWWWWW     SSS        WWWWW         S L LLLLLL L S         WWWWW        SSS     WWWWWWWW WWWWWWWW  SS    WW
 WWSS? SSSWWWWWWWWWWWWWWWWW F  SS  LLLLL    WWWWWWSSSS  S  L   !!   L  S  SSSSWWWWWW    LLLLL  SS  F WWWWWWWWWWWWWWWWWSSS ?SSWW 
 WWWSWSSWWWWLLWWWWWWWW W WW    S   L$ $L    WWWW  S  SSSS  LLLL!!LLLL  SSSS  S  WWWW    L$ $L   S    WW W WWWWWWWWLLWWWWSSWSWWW 
 WWWSSSSWWWWLLWWWWWWWWWW           L ? !!   WWW      S  SSS          SSS  S      WWW   !! ? L           WWWWWWWWWWLLWWWWSSSSWWW 
 WWWWWSSWWWWWWWWWWW WWW            L$ $L    WW    W  S    SS  TTTT  SS    S  W    WW    L$ $L            WWW WWWWWWWWWWWSSWWWWW 
 WW WWWWWWWWWWWWWWWWWWF           FLLLLLSSS  W    WW S  F  SSS    SSS  F  S WW    W  SSSLLLLLF           FWWWWWWWWWWWWWWWWWW WW 
 WW WWWWWWWWWWWWWW WWWFF                S    W     W SS    SSS    SSS    SS W     W    S                FFWWW WWWWWWWWWWWWWW WW 
 WWWWW WWWWWWWWWLWWWWW                       W     WWWSS  SS        SS  SSWWW     W                       WWWWWLWWWWWWWWW WWWWW 
  WW WWWWWWWWWWWWWWWWWWF   F    WWW                     SSS        SSS                      WWW    F   FWWWWWWWWWWWWWWWWWW WW  
WWWWWSSSWWWWWWWWWWWWFFWF     W  WWW       !       W    SSSSS        SSSSS    W       !       WWW  W     FWFFWWWWWWWWWWWWSSSWWWWW
W WWWS SSWWWWWWWWWWW FF      W W WW               W    S SSS  F  F  SSS S    W               WW W W      FF WWWWWWWWWWWSS SWWW W
WWWWWSS SWWWWWWWWWWWW W                 F   !          SSSSSSS    SSSSSSS          !   F                 W WWWWWWWWWWWWS SSWWWWW
WW WWWW SWWWWWWWWW WWWW       W     W                      SSSSSSSSSS                      W     W       WWWW WWWWWWWWWS WWWW WW
WWWWWWWWWWWWWWWWWWWWWWW                         !     WW                WW     !                         WWWWWWWWWWWWWWWWWWWWWWW
 WWW WW  WWWWWLLLLLLLWWW                        !                              !                        WWWLLLLLLLWWWWW  WW WWW 
 WWW WWWWWWWWH       LWWWWWLWW          F                                              F          WWLWWWWWL       HWWWWWWWW WWW 
WWWWWWWWWWWWWWLLLLL   LWWW WWW  WWW                     WHW          WBW                     WWW  WWW WWWL   LLLLLWWWWWWWWWWWWWW
 WWWWWWWWWWWWWWWW  $ !  WLWWWWWW WWWWWW           F  WWWWWWWWWWWWWWWWWWWWWW  F           WWWWWW WWWWWWLW  ! $  WWWWWWWWWWWWWWWW 
  WWWWWWWWWWWWWWW!!!!     WWWWWWWWWWWWW            WWWWWWWWWWWWWWWWWWWWWWWWWW            WWWWWWWWWWWWW     !!!!WWWWWWWWWWWWWWW  
 WWWWWWWWWWWWWW W !       WW        WWWWW        WWWWWWWW    WWWWWW    WWWWWWWW        WWWWW        WW       ! W WWWWWWWWWWWWWW 
 W  WWW WW  WWW W         WW F S  S  WWWWWW     WWWW        F  WW  F        WWWW     WWWWWW  S  S F WW         W WWW  WW WWW  W 
 WD WWWWWWWWWW W    SS     WW     S  WWWWWW!   WWW                            WWW   !WWWWWW  S     WW     SS    W WWWWWWWWWW DW 
 WDD WWWWWW W WW     S     WWF   SS   W WW!WW WWWW  F                      F  WWWW WW!WW W   SS   FWW     S     WW W WWWWWW DDW 
 WLL!W WWWWWWW      SS  W  WW    S S     !WWWWWWWW                            WWWWWWWW!     S S    WW  W  SS      WWWWWWW W!LLW 
     WWWW WWW    F   S WW  WWF        S    WWWWW                                WWWWW    S        FWW  WW S   F    WWW WWWW     
  W WWWWWW W            W  WW          S     W       !     F        F     !       W     S          WW  W            W WWWWWW W  
  WWWWWWWWWW            W   WWF         S        WW     !!            !!     WW        S         FWW   W            WWWWWWWWWW  
  WWWW WWWWW                WW          S        WW  !  !D!          !D!  !  WW        S          WW                WWWWW WWWW  
  WWWWWWWWWW       F!       W F     $   SS          !    !    !  !    !    !          SS   $     F W       !F       WWWWWWWWWW  
WWWWWWWWWWW W      !        WW         S$S   F                !!!!                F   S$S         WW        !      W WWWWWWWWWWW
WWWWWWWWW WWW         !$!!  WW         SSSS          !!!                !!!          SSSS         WW  !!$!         WWW WWWWWWWWW
 WWWWWWWW WWW          !$    WW        SS S   !!      !    F        F    !      !!   S SS        WW    $!          WWW WWWWWWWW 
WWWWWWWWWWWWWWW         !    WWW               !          !          !          !               WWW    !         WWWWWWWWWWWWWWW
WWWWWWW WW W  WW WW          !!WWWW $                      !        !                      $ WWWW!!          WW WW  W WW WWWWWWW
 WW WWWWWWW    WWWW           !!WWH      !!           S    L L LL L L    S           !!      HWW!!           WWWW    WWWWWWW WW 
 WWWWWWWW       W WW   $       ! W       !!!     SS        L L LL L L        SS     !!!       W !       $   WW W       WWWWWWWW 
SWWWWWW           WW                    !B!       SS       L$      $L       SS       !B!                    WW           WWWWWWS
SWW         !                          !!!!   LLL S        L        L        S LLL   !!!!                          !         WWS
 WW   ! !!    S             F            F   LL LLSS     LLLL      LLLL     SSLL LL   F            F             S    !! !   WW 
 WW           SSSS         F F        W     LL F LLSS LLLL            LLLL SSLL F LL     W        F F         SSSS           WW 
 W          SSSSS S         F    SS  WWW    L                                      L    WWW  SS    F         S SSSSS          W 
 W          SSSSSS S  !          SSS   W    L  F   LLL LLL LLL    LLL LLL LLL   F  L    W   SSS          !  S SSSSSS          W 
 W     $     SSS SSS              S!   W F  LL     LLLLLLLLLLL$  $LLLLLLLLLLL     LL  F W   !S              SSS SSS     $     W 
WW       $    SSSSSS               SS        LL    LLL?LLL$LLL    LLL$LLL?LLL    LL        SS               SSSSSS    $       WW
WWW    L?L    SSSSSSS  !    F   S   SS        LL    L        SS  SS        L    LL        SS   S   F    !  SSSSSSS    L?L    WWW
WWW   !LLL    SSSSSSS       !        S         LL  LLL T   F  SSSS  F   T LLL  LL         S        !       SSSSSSS    LLL!   WWW
WWW  LTL     SSSS$SSSS                             LLLT        SS        TLLL                             SSSS$SSSS     LTL  WWW
WWW  LL      S S  SSSS WW                          LLL  F              F  LLL                          WW SSSS  S S      LL  WWW
 WW            SSSS   WWW S    F !    LLL           LB!  LLL$LL  LL$LLL  !BL           LLL    ! F    S WWW   SSSS            WW 
 WW             SS         S         L$  LL LLLLL  LLL     LLL    LLL     LLL  LLLLL LL  $L         S         SS             WW 
WW    !    !            F   $        L $  L L      LLL  L              L  LLL      L L  $ L        $   F            !    !    WW
WW               $  S            !F  L    L L      LLL  L  LLLL  LLLL  L  LLL      L L    L  F!            S  $               WW
WWW            $  SSS    !  !        !L        F    L   L TL        LT L   L    F        L!        !  !    SSS  $            WWW
WWW     F  !          F       F       LLL   S           L  L   D    L  L           S   LLL       F       F          !  F     WWW
WWW                $FFFF                L   SSS                @                 SSS   L                FFFF$                WWW
                WWW$FFFF                L   SSS                                  SSS   L                FFFF$WWW                
  F     WWW!          F       F       LLL   S           L  L        L  L           S   LLL       F       F          !WWW     F  
            WWW$    SSS  !  !        !L        F    L   L TL        LT L   L    F        L!        !  !  SSS    $WWW            
               WW$            S  !F  L    L L      LLL  L  LLLL  LLLL  L  LLL      L L    L  F!  S            $WW               
    WW!    !   F            $ L        $  L L      LLL  L              L  LLL      L L  $        L $            F   !    !WW    
L         S         SS             WW $  LL LLLLL  LLL     LLL    LLL     LLL  LLLLL LL  $ WW             SS         S         L
 F    S WWW   SSSS            WW !BL           LLL    !LLL  $LL  LL$  LLL!    LLL           LB! WW            SSSS   WWW S    F 
WWW  LL      S S  SSSS WW                          LLL  F              F  LLL                          WW SSSS  S S      LL  WWW
SSSS     LTL  WWW$SSSS                             LLLT        SS        TLLL                             SSSS$WWW  LTL     SSSS
   WWW!       SSSSSSS    LLL!        S         LL  LLL T   F  SSSS  F   T LLL  LL         S        !LLL    SSSSSSS       !WWW   
L    WWW?  SSSSSSS    L!    F   S   SS        LL    L        SS  SS        L    LL        SS   S   F    !L    SSSSSSS  ?WWW    L
       WW$LLL    LL        SS               SSSSSS    ?LLL$LLL    LLL$LLL?    SSSSSS               SS        LL    LLL$WW       
     W $S              SSS SSS     !LLLLLLLLLLL     LL  F W   $  $   W F  LL     LLLLLLLLLLL!     SSS SSS              S$ W     
  S SSSSSS          W !          SSS   W    L  F   LLL LLL LLL    LLL LLL LLL   F  L    W   SSS          ! W          SSSSSS S  
 W          SSSSS S         F    SS  WWW    L                                      L    WWW  SS    F         S SSSSS          W 
 WW           SSSS         F F        W     LL F LLSS LLLL            LLLL SSLL F LL     W        F F         SSSS           WW 
   WW ! !!    S             F            F   LL LLSS     LLLL      LLLL     SSLL LL   F            F             S    !! ! WW   
         WWS!                          !!!!   LLL S        L        L        S LLL   !!!!                          !SWW         
                    WW           WWWWWWS!B!L       SS       $      $       SS       L!B!SWWWWWW           WW                    
   WW W       WWWWWWWW $       !       W !!!     SS        L L LL L L        SS     !!! W       !       $ WWWWWWWW       W WW   
           WWWW    WWWWWWW WW !!      HWW!!           S    L L LL L L    S           !!WWH      !! WW WWWWWWW    WWWW           
          WW WW  W WW WWWWWWW!! WWWW$                      !        !                      $WWWW !!WWWWWWW WW W  WW WW          
         WWWWWWWWWWWWWWW!               WWW    !          !          !          !    WWW               !WWWWWWWWWWWWWWW         
          WWW WWWWWWWW !$   S SS        WW    !!      !    F        F    !      !!    WW        SS S   $! WWWWWWWW WWW          
         WWW WWWWWWWWW!$!!          SSSS         WW  !!!                !!!  WW         SSSS          !!$!WWWWWWWWW WWW         
      W WWWWWWWWWWW!S         WW        $                F   S!!!!S   F                $        WW         S!WWWWWWWWWWW W      
F       WWWWWWWWWW  !     F W       $          SS   !    !    !  !    !    !   SS          $       W F     !  WWWWWWWWWW       F
  WW        S          WW                WWWWW WWWW  !  !D!          !D!  !  WWWW WWWWW                WW          S        WW  
     WW        S         FWW   W            WWWWWWWWWW  !!            !!  WWWWWWWWWW            W   WWF         S        WW     
       W     S          WW  W            W WWWWWW W  !     F        F     !  W WWWWWW W            W  WW          S     W       
     WWWW WWW    F   S WW  WWF        S    WWWWW                                WWWWW    S        FWW  WW S   F    WWW WWWW     
LLW !     S S    WW  W  SS      WWWWWWW W!WWWWWWWW                            WWWWWWWW!W WWWWWWW      SS  W  WW    S S     ! WLL
WW W   SS   FWW     S     WW W WWWWWW DDW !WW WWWW  F                      F  WWWW WW! WDD WWWWWW W WW     S     WWF   SS   W WW
WWWWWW  S     WW     SS    W WWWWWWWWWW DW !   WWW                            WWW   ! WD WWWWWWWWWW W    SS     WW     S  WWWWWW
 W  WWW WW  WWW W         WW F S  S  WWWWWW     WWWW        F  WW  F        WWWW     WWWWWW  S  S F WW         W WWW  WW WWW  W 
 W WWWWWWWWWWWWWW !       WW        WWWWW        WWWWWWWW    WWWWWW    WWWWWWWW        WWWWW        WW       ! WWWWWWWWWWWWWW W 
WWWWWWWWWWWWWWW  !!!!     WWWWWWWWWWWWW            WWWWWWWWWWWWWWWWWWWWWWWWWW            WWWWWWWWWWWWW     !!!!  WWWWWWWWWWWWWWW
  WWWWWWWWWWWWWWWW $ !  WLWWWWWW WWWWWW           F  WWWWWWWWWWWWWWWWWWWWWW  F           WWWWWW WWWWWWLW  ! $ WWWWWWWWWWWWWWWW  
WWWWWWWWWWWWWWLLLLL   LWWW WWW  WWW                     W W          W W                     WWW  WWW WWWL   LLLLLWWWWWWWWWWWWWW
 WWW WWWWWWWWH       LWWWWWLWW          F                                              F          WWLWWWWWL       HWWWWWWWW WWW 
                        WWWLLLLLLLWWWWW  WW WWW !                              ! WWW WW  WWWWWLLLLLLLWWW                        
                         WWWWWWWWWWWWWWWWWWWWWWW!     WW                WW     !WWWWWWWWWWWWWWWWWWWWWWW                         
WW WWWW SWWWWWWWWW WWWW       W     W                      SSSSSSSSSS                      W     W       WWWW WWWWWWWWWS WWWW WW
   F                 W WWWWWWWWWWWWS SSWWWWW!          SSSSSSS    SSSSSSS          !WWWWWSS SWWWWWWWWWWWW W                 F   
W WWWS SSWWWWWWWWWWW FF      W W WW               W    S SSS  F  F  SSS S    W               WW W W      FF WWWWWWWWWWWSS SWWW W
       WWW  W     FWFFWWWWWWWWWWWWSSSWWWWW!       W    SSSSS        SSSSS    W       !WWWWWSSSWWWWWWWWWWWWFFWF     W  WWW       
  WW WWWWWWWWWWWWWWWWWWF   F    WWW                      SSS        SSS                      WWW    F   FWWWWWWWWWWWWWWWWWW WW  
 WWWWW WWWWWWWWWLWWWWW                       W     WWWSS  SS        SS  SSWWW     W                       WWWWWLWWWWWWWWW WWWWW 
 WW WWWWWWWWWWWWWW WWWFF                S    W     W SS    SSS    SSS    SS W     W    S                FFWWW WWWWWWWWWWWWWW WW 
 WW WWWWWWWWWWWWWWWWWWF           FLLLLLSSS  W    WW S  F  SSS    SSS  F  S WW    W  SSSLLLLLF           FWWWWWWWWWWWWWWWWWW WW 
L            WWW WWWWWWWWWWWSSWWWWW $ $L    WW    W  S    SS        SS    S  W    WW    L$ $ WWWWWSSWWWWWWWWWWW WWW            L
 L           WWWWWWWWWWLLWWWWSSSSWWW ? !!   WWW      S  SSS          SSS  S      WWW   !! ? WWWSSSSWWWWLLWWWWWWWWWW           L 
L   S    WW W WWWWWWWWLLWWWWSSWSWWW $ $LLLL  SSSS  S  WWWW    L!!L    WWWW  S  SSSS  LLLL$ $ WWWSWSSWWWWLLWWWWWWWW W WW    S   L
SSWW ?   L  S  SSSSWWWWWW    LLLLL  SS  F WWWWWWWWWWWWWWWWWSSS !! SSSWWWWWWWWWWWWWWWWW F  SS  LLLLL    WWWWWWSSSS  S  L   ? WWSS
WW    SS  WWWWWWWW WWWWWWWW     SSS        WWWWW         S L LLLLLL L S         WWWWW        SSS     WWWWWWWW WWWWWWWW  SS    WW
WWWWWW   SSSSSS       W WWWWWWWWWWWWW L  SSS   W?     L  SSL L    L LSS  L     ?W   SSS  L WWWWWWWWWWWWW W       SSSSSS   WWWWWW
WWWSS S    WWWWWWWWWWW WWW    SSSSSSS        WW       L  SSL L DD L LSS  L       WW        SSSSSSS    WWW WWWWWWWWWWW    S SSWWW
 WWWLW WWWWW       WWW$ WW    SSSS                  LLT  S L L    L L S  TLL                  SSSS    WW $WWW       WWWWW WLWWW 
LL L S     LL           F           WW WWWWWWWW W WW       WWW !! WWW       WW W WWWWWWWW WW           F           LL     S L LL
 S L     L    SSS            W  WWWWWWWWWWWWWW WWW     W W !!  !!  !! W W     WWW WWWWWWWWWWWWWW  W            SSS    L     L S 
LL  SSSS       WWWWWWWW WWWWWW WWWWWWWWWWW WWWWW !   LL  S LLLLLLLLLL S  LL   ! WWWWW WWWWWWWWWWW WWWWWW WWWWWWWW       SSSS  LL
 WWWWWWW WW WW WWWWWWWWWWWW  WWWW      SSS    L F LLL   SS            SS   LLL F L    SSS      WWWW  WWWWWWWWWWWW WW WW WWWWWWW 
WW WW   W WW WWWWW WW WWWWWWWWWWW     SS     LL FF  L  SSS SS      SS SSS  L  FF LL     SS     WWWWWWWWWWW WW WWWWW WW W   WW WW
 LL        WWWWWWWWWWWWWW    WW              W $$F?    S SSSSSS  SSSSSS S    ?F$$ W              WW    WWWWWWWWWWWWWW        LL 
